10 10
S 0 a W 0 0 a W 0 G
0 0 W a 0 0 A W A W
W A W 0 0 W 0 0 0 W
0 0 0 W A W 0 0 0 W
0 0 W W 0 0 W W W W
0 0 A 0 0 0 0 0 0 a
W a W 0 0 0 0 0 W W
W W W W W 0 0 0 0 0
m 0 0 0 0 0 0 0 0 0
W 0 0 0 0 0 0 0 0 0